et	$AND
ou	$OR
d'un	$TRASH
un	$TRASH
aux	$TRASH
dans	$TRASH
?	$TRASH
!	$TRASH
,	$TRASH
;	$TRASH
.	$TRASH
de	$TRASH
du	$TRASH
l'ensemble	$TRASH
des	$TRASH
je	$TRASH
qui	$TRASH
dont	$TRASH
la	$TRASH
liste	$TRASH
toutes	$TRASH
les	$TRASH
le	$TRASH
terme	$TRASH
moi	$TRASH
ensemble	$TRASH
l	$TRASH
d	$TRASH
a	$TRASH
fois	$TRASH
à	$TRASH
il	$TRASH
y	$TRASH
a	$TRASH
est	$TRASH
est-il	$TRASH
est-elle	$TRASH
l'	$TRASH
font	$TRASH
t-il	$TRASH
sont	$TRASH
savoir	$TRASH
tous	$TRASH
par	$TRASH
ayant	$TRASH
en	$TRASH
intervenu	$TRASH
avril	avril
janvier	janvier
février	février
mars	mars
mai	mai
juin	juin
juillet	juillet
août	août
septembre	septembre
octobre	octobre
novembre	novembre
décembre	décembre
donne	$SELECT
donne-moi	$SELECT
donner	$SELECT
donnez	$SELECT
existe-t-il	$SELECT
a-t-il	$SELECT
j'aimerais	$SELECT
souhaiterais	$SELECT
veux	$SELECT
voudrais	$SELECT
retourner	$SELECT
quel	$SELECT
quels	$SELECT
quelle	$SELECT
quelles	$SELECT
veux	$SELECT
combien	$COUNT
une	$UNE
unes	$UNE
focus	$FOCUS
grostitres	$GROSTITRE
grostitre	$GROSTITRE
gros	$GROSTITRE
titres	$GROSTITRE
titre	$GROSTITRE
breve	$BREVE
breves	$BREVE
brève	$BREVE
brèves	$BREVE
rappels	$BREVE
rappel	$BREVE
voir-aussi	$VOIRAUSSI
voirs-aussi	$VOIRAUSSI
article	$PAGE
articles	$PAGE
articlent	$PAGE
pages	$PAGE
d'article	$PAGE
d'articles	$PAGE
écrits	$ABOUT
traite	$ABOUT
traitent	$ABOUT
traitants	$ABOUT
traitant	$ABOUT
parlent	$ABOUT
sur	$ABOUT
évoque	$ABOUT
concernent	$ABOUT
concernes	$ABOUT
concerne	$ABOUT
concernant	$ABOUT
sujet	$ABOUT
thème	$ABOUT
theme	$ABOUT
parle	$ABOUT
parlant	$ABOUT
parlait-on	$ABOUT
parle-t-on	$ABOUT
contenir	$ABOUT
mot	$ABOUT
possédant	$ABOUT
possedant	$ABOUT
propos	$ABOUT
porte	$ABOUT
apparu	$ABOUT
reference	$ABOUT
référence	$ABOUT
auteur	$AUTHOR
auteurs	$AUTHOR
écrit	$AUTHOR
écrites	$AUTHOR
écris	$AUTHOR
proviennent	$AUTHOR